no,name,kor,eng,math,total,avg
1,Daron,45,32,59,136,45.3333333333
2,Robbie,48,2,52,102,34
3,Denver,21,66,49,136,45.3333333333
4,Pierson,83,85,2,170,56.6666666667
5,Paulo,65,47,65,177,59
6,Garth,32,4,93,129,43
7,Ashleigh,10,86,31,127,42.3333333333
8,Sibella,55,90,71,216,72
9,Guillemette,66,93,81,240,80
10,Inger,15,74,88,177,59
11,Finn,100,4,43,147,49
12,Keeley,52,13,8,73,24.3333333333
13,Charlton,7,3,14,24,8
14,Orly,16,2,33,51,17
15,Marty,1,48,9,58,19.3333333333
16,Eberhard,12,54,41,107,35.6666666667
17,Giustina,55,54,1,110,36.6666666667
18,Leopold,94,61,39,194,64.6666666667
19,Clemmy,32,32,99,163,54.3333333333
20,Rakel,75,57,35,167,55.6666666667
21,Myrlene,100,75,74,249,83
22,Laraine,8,17,84,109,36.3333333333
23,Arty,95,61,41,197,65.6666666667
24,Xaviera,49,15,49,113,37.6666666667
25,Cindy,40,44,1,85,28.3333333333
26,Jacquenetta,24,51,89,164,54.6666666667
27,Kiel,70,18,95,183,61
28,Arlie,27,92,39,158,52.6666666667
29,Jana,71,23,46,140,46.6666666667
30,Nerti,25,84,90,199,66.3333333333
31,Deloris,21,99,91,211,70.3333333333
32,Mufinella,15,28,61,104,34.6666666667
33,Angie,1,19,86,106,35.3333333333
34,Bevan,51,7,32,90,30
35,Elisabeth,19,36,75,130,43.3333333333
36,Sibyl,76,53,28,157,52.3333333333
37,Rois,59,32,51,142,47.3333333333
38,Ilario,7,6,56,69,23
39,Caitlin,63,19,22,104,34.6666666667
40,Hersh,75,45,1,121,40.3333333333
41,Gusella,72,27,80,179,59.6666666667
42,Cass,100,75,69,244,81.3333333333
43,Alfie,9,2,74,85,28.3333333333
44,Sandye,74,28,14,116,38.6666666667
45,Nolan,50,30,55,135,45
46,Rani,96,19,70,185,61.6666666667
47,Babb,63,31,95,189,63
48,Donny,61,48,87,196,65.3333333333
49,Taddeusz,59,96,39,194,64.6666666667
50,Garwin,68,88,30,186,62
51,Lenee,15,62,72,149,49.6666666667
52,Oby,78,35,92,205,68.3333333333
53,Ruben,40,19,58,117,39
54,Arel,53,6,4,63,21
55,Korney,97,65,30,192,64
56,Phineas,2,32,19,53,17.6666666667
57,Paco,75,62,47,184,61.3333333333
58,Lawry,100,97,34,231,77
59,Dylan,55,46,47,148,49.3333333333
60,Morissa,42,71,5,118,39.3333333333
61,Aleda,92,74,82,248,82.6666666667
62,Gabrielle,32,81,66,179,59.6666666667
63,Lira,12,40,71,123,41
64,Hetty,10,43,10,63,21
65,Sibelle,35,70,78,183,61
66,Eustacia,98,18,27,143,47.6666666667
67,Butch,94,100,65,259,86.3333333333
68,Michele,43,50,65,158,52.6666666667
69,Malva,94,98,10,202,67.3333333333
70,Lorilee,46,100,46,192,64
71,Abigale,78,8,49,135,45
72,Averil,17,43,19,79,26.3333333333
73,Mattie,54,33,25,112,37.3333333333
74,Kingsly,94,77,5,176,58.6666666667
75,Laural,23,55,61,139,46.3333333333
76,Chandra,82,30,92,204,68
77,Bel,23,31,45,99,33
78,Faber,49,74,5,128,42.6666666667
79,Edd,61,80,16,157,52.3333333333
80,Cecilia,94,93,36,223,74.3333333333
81,Quintin,97,69,82,248,82.6666666667
82,Allene,76,23,12,111,37
83,Allistir,100,86,60,246,82
84,Garrik,1,19,35,55,18.3333333333
85,Rozamond,27,9,84,120,40
86,Annabelle,74,22,31,127,42.3333333333
87,Dav,53,47,73,173,57.6666666667
88,Concettina,28,8,72,108,36
89,Claudie,1,20,79,100,33.3333333333
90,Miles,1,67,54,122,40.6666666667
91,Veronica,80,38,91,209,69.6666666667
92,Saxon,77,29,16,122,40.6666666667
93,Irvin,21,82,20,123,41
94,Aindrea,77,54,2,133,44.3333333333
95,Jarrid,91,22,67,180,60
96,Felecia,10,7,40,57,19
97,Curry,52,98,13,163,54.3333333333
98,Theo,74,64,97,235,78.3333333333
99,Delia,17,65,15,97,32.3333333333
100,Howie,96,47,37,180,60
101,Dallon,34,45,29,108,36
102,Karlens,64,73,7,144,48
103,Marita,26,58,25,109,36.3333333333
104,Joela,25,12,63,100,33.3333333333
105,Rafa,80,61,70,211,70.3333333333
106,Bearnard,90,30,48,168,56
107,Agneta,1,43,77,121,40.3333333333
108,Garth,42,32,93,167,55.6666666667
109,Starlene,1,61,94,156,52
110,Angelica,95,3,21,119,39.6666666667
111,Annora,21,13,100,134,44.6666666667
112,Dix,16,8,70,94,31.3333333333
113,Gustavus,38,37,2,77,25.6666666667
114,Delia,60,82,55,197,65.6666666667
115,Lura,35,88,70,193,64.3333333333
116,Norene,60,9,3,72,24
117,Wallas,72,86,32,190,63.3333333333
118,Averyl,5,65,17,87,29
119,Toby,64,35,98,197,65.6666666667
120,Felizio,52,69,35,156,52
121,Katlin,32,16,19,67,22.3333333333
122,Ryan,39,44,18,101,33.6666666667
123,Vivian,44,8,42,94,31.3333333333
124,Daphene,47,59,4,110,36.6666666667
125,Kaitlyn,78,87,25,190,63.3333333333
126,Sayers,52,69,95,216,72
127,Grant,71,30,71,172,57.3333333333
128,Dick,5,32,26,63,21
129,Wallie,97,92,62,251,83.6666666667
130,Tallulah,92,33,60,185,61.6666666667
131,Juline,31,25,7,63,21
132,Amye,23,44,44,111,37
133,Willetta,35,79,73,187,62.3333333333
134,Roberta,54,60,77,191,63.6666666667
135,Briney,55,4,65,124,41.3333333333
136,Aluin,94,17,33,144,48
137,Delmer,44,29,15,88,29.3333333333
138,Valentine,5,64,21,90,30
139,Corly,29,13,52,94,31.3333333333
140,Aubine,9,13,26,48,16
141,Pyotr,21,30,2,53,17.6666666667
142,Burk,2,55,15,72,24
143,Krissy,14,7,91,112,37.3333333333
144,Dede,86,73,22,181,60.3333333333
145,Falito,100,68,75,243,81
146,Merrily,17,64,30,111,37
147,Lowe,8,26,93,127,42.3333333333
148,Janis,93,90,2,185,61.6666666667
149,Arda,98,16,95,209,69.6666666667
150,Alex,83,42,24,149,49.6666666667
151,Tandie,92,79,12,183,61
152,Axel,83,90,49,222,74
153,Margaretha,28,82,52,162,54
154,Peterus,69,33,90,192,64
155,Ave,52,67,18,137,45.6666666667
156,Adrianne,44,37,13,94,31.3333333333
157,Slade,95,6,47,148,49.3333333333
158,Yulma,40,90,40,170,56.6666666667
159,Tessie,53,73,48,174,58
160,Gaylord,70,13,92,175,58.3333333333
161,Adiana,27,36,35,98,32.6666666667
162,Sherm,68,68,52,188,62.6666666667
163,Geoffrey,41,4,30,75,25
164,Ardisj,55,4,33,92,30.6666666667
165,Sharity,86,9,35,130,43.3333333333
166,Berget,64,45,87,196,65.3333333333
167,Nicolas,31,17,60,108,36
168,Ambrosio,31,58,1,90,30
169,Cassey,32,28,73,133,44.3333333333
170,Darsie,71,79,88,238,79.3333333333
171,Katuscha,4,82,74,160,53.3333333333
172,Salmon,2,69,96,167,55.6666666667
173,Nate,45,28,73,146,48.6666666667
174,Casper,40,9,75,124,41.3333333333
175,Hewett,82,3,76,161,53.6666666667
176,Helsa,94,60,47,201,67
177,Ardelis,34,3,98,135,45
178,Reggi,94,50,11,155,51.6666666667
179,Quinn,91,83,86,260,86.6666666667
180,Ashlan,9,25,53,87,29
181,Johann,6,20,58,84,28
182,Dale,62,96,65,223,74.3333333333
183,Cedric,76,65,72,213,71
184,Rebecka,58,36,62,156,52
185,Jimmie,4,18,30,52,17.3333333333
186,Roda,23,49,70,142,47.3333333333
187,Marylynne,29,17,55,101,33.6666666667
188,Armstrong,98,64,41,203,67.6666666667
189,Carlene,71,78,47,196,65.3333333333
190,Eunice,73,14,43,130,43.3333333333
191,Culver,27,43,42,112,37.3333333333
192,Sophey,57,42,90,189,63
193,Garland,23,33,72,128,42.6666666667
194,Marianne,89,51,5,145,48.3333333333
195,Kristofor,48,82,38,168,56
196,Urson,34,83,37,154,51.3333333333
197,Harland,54,21,10,85,28.3333333333
198,Cthrine,60,18,24,102,34
199,Marleah,53,40,67,160,53.3333333333
200,Isabella,62,26,2,90,30
201,Pia,47,42,27,116,38.6666666667
202,Rolph,57,87,63,207,69
203,Gratiana,84,71,53,208,69.3333333333
204,Lilia,57,34,52,143,47.6666666667
205,Elaina,9,69,58,136,45.3333333333
206,Devin,85,97,45,227,75.6666666667
207,Mireielle,83,46,6,135,45
208,Kingsley,18,25,42,85,28.3333333333
209,Immanuel,22,25,84,131,43.6666666667
210,Emmanuel,55,21,92,168,56
211,Rafaela,94,73,74,241,80.3333333333
212,Jonah,2,27,41,70,23.3333333333
213,Burty,43,35,11,89,29.6666666667
214,Elbertine,18,1,83,102,34
215,Anette,28,77,77,182,60.6666666667
216,Alicia,86,11,50,147,49
217,Herb,24,86,97,207,69
218,Archy,16,19,46,81,27
219,Daune,11,61,10,82,27.3333333333
220,Sorcha,6,41,95,142,47.3333333333
221,Stacie,30,65,43,138,46
222,Vitoria,64,56,7,127,42.3333333333
223,Eachelle,30,2,87,119,39.6666666667
224,Nicolas,58,39,30,127,42.3333333333
225,Tudor,96,89,44,229,76.3333333333
226,Dame,19,62,62,143,47.6666666667
227,Jenni,20,99,82,201,67
228,Boy,4,82,54,140,46.6666666667
229,Doris,1,44,21,66,22
230,Niki,42,33,90,165,55
231,Jody,54,82,55,191,63.6666666667
232,Misti,24,20,93,137,45.6666666667
233,Phillis,75,27,80,182,60.6666666667
234,Vale,45,85,5,135,45
235,Duffy,44,86,8,138,46
236,Duff,88,13,32,133,44.3333333333
237,Evered,4,81,81,166,55.3333333333
238,Marian,37,8,36,81,27
239,Oona,77,36,74,187,62.3333333333
240,Katerina,84,24,50,158,52.6666666667
241,Irwin,20,10,79,109,36.3333333333
242,Grange,96,8,91,195,65
243,Borden,91,4,90,185,61.6666666667
244,Adriana,100,60,67,227,75.6666666667
245,Virgilio,23,42,39,104,34.6666666667
246,Bernard,13,56,15,84,28
247,Lilith,28,61,17,106,35.3333333333
248,Eveleen,2,71,12,85,28.3333333333
249,Ermengarde,55,7,33,95,31.6666666667
250,Brunhilda,56,99,60,215,71.6666666667
251,Lorne,50,81,6,137,45.6666666667
252,Wesley,86,8,62,156,52
253,Georgette,41,3,71,115,38.3333333333
254,Melodie,61,22,92,175,58.3333333333
255,Hestia,29,79,15,123,41
256,Cullen,94,23,23,140,46.6666666667
257,Jessika,95,82,7,184,61.3333333333
258,Holli,75,30,46,151,50.3333333333
259,Simmonds,98,80,15,193,64.3333333333
260,Mariquilla,28,60,85,173,57.6666666667
261,Bronny,13,68,19,100,33.3333333333
262,Jobi,90,42,94,226,75.3333333333
263,Fulton,1,17,85,103,34.3333333333
264,Dal,69,16,6,91,30.3333333333
265,Kyle,42,27,73,142,47.3333333333
266,Estell,44,59,23,126,42
267,Gayla,16,7,74,97,32.3333333333
268,Kelley,4,99,79,182,60.6666666667
269,Terrill,27,79,35,141,47
270,Rowen,86,15,21,122,40.6666666667
271,Kayne,86,34,50,170,56.6666666667
272,Marney,68,84,96,248,82.6666666667
273,Aime,16,29,74,119,39.6666666667
274,Nataline,5,33,84,122,40.6666666667
275,Kendra,12,20,13,45,15
276,Vyky,79,14,60,153,51
277,Brigg,15,97,38,150,50
278,Burnaby,35,39,95,169,56.3333333333
279,Nikoletta,24,59,94,177,59
280,Mariann,88,29,11,128,42.6666666667
281,Hammad,2,71,75,148,49.3333333333
282,Lynelle,46,63,14,123,41
283,Celisse,37,69,78,184,61.3333333333
284,Redford,16,43,62,121,40.3333333333
285,Maisey,56,9,34,99,33
286,Mohandis,95,23,55,173,57.6666666667
287,Dawna,53,45,77,175,58.3333333333
288,Sayres,67,66,27,160,53.3333333333
289,Paton,94,79,77,250,83.3333333333
290,Jeanna,80,59,51,190,63.3333333333
291,Nessa,79,38,51,168,56
292,Deidre,45,76,11,132,44
293,Catina,80,62,33,175,58.3333333333
294,Marlow,64,2,78,144,48
295,Alice,7,70,96,173,57.6666666667
296,Yankee,48,54,21,123,41
297,Sheelah,12,2,94,108,36
298,Elsy,54,54,100,208,69.3333333333
299,Elke,86,49,97,232,77.3333333333
300,Liam,1,42,85,128,42.6666666667
301,Ivette,69,75,88,232,77.3333333333
302,Adrian,50,71,99,220,73.3333333333
303,Ellissa,32,7,94,133,44.3333333333
304,Lee,16,90,60,166,55.3333333333
305,Valry,62,91,3,156,52
306,Gerianne,95,56,11,162,54
307,Veronique,72,83,82,237,79
308,Hasty,85,92,5,182,60.6666666667
309,Trixi,45,54,1,100,33.3333333333
310,Hamid,28,59,60,147,49
311,Damien,55,32,3,90,30
312,Jeniece,45,11,93,149,49.6666666667
313,Kiley,57,26,50,133,44.3333333333
314,Glyn,57,68,62,187,62.3333333333
315,Ebeneser,18,59,41,118,39.3333333333
316,Sallyann,61,55,38,154,51.3333333333
317,Guinna,8,67,64,139,46.3333333333
318,Terrye,58,85,13,156,52
319,Robinet,29,51,82,162,54
320,Dru,18,41,99,158,52.6666666667
321,Constancy,72,38,35,145,48.3333333333
322,Poppy,89,51,29,169,56.3333333333
323,Monro,61,24,96,181,60.3333333333
324,Aggie,5,64,98,167,55.6666666667
325,Cathlene,10,92,65,167,55.6666666667
326,Norbert,71,32,2,105,35
327,Basil,62,48,52,162,54
328,Ezekiel,70,57,7,134,44.6666666667
329,Lishe,42,98,25,165,55
330,Clemmy,14,23,70,107,35.6666666667
331,Twila,37,32,3,72,24
332,Pier,15,59,98,172,57.3333333333
333,Reinold,59,46,25,130,43.3333333333
334,Mathias,82,19,72,173,57.6666666667
335,Katleen,96,88,29,213,71
336,Abrahan,9,16,67,92,30.6666666667
337,Hattie,78,45,76,199,66.3333333333
338,Cherin,53,58,36,147,49
339,Harriett,39,84,15,138,46
340,Genevieve,9,48,31,88,29.3333333333
341,Demeter,21,16,15,52,17.3333333333
342,Beltran,96,58,15,169,56.3333333333
343,Sara,36,33,90,159,53
344,Reid,53,48,71,172,57.3333333333
345,Moreen,17,27,9,53,17.6666666667
346,Broddie,10,96,96,202,67.3333333333
347,Amargo,91,34,83,208,69.3333333333
348,Meryl,84,60,76,220,73.3333333333
349,Arie,27,35,18,80,26.6666666667
350,Maurizio,50,23,86,159,53
351,Sibel,81,91,82,254,84.6666666667
352,Randie,67,75,29,171,57
353,Kriste,36,97,28,161,53.6666666667
354,Wendell,74,54,57,185,61.6666666667
355,Prudence,55,91,4,150,50
356,Armstrong,39,30,36,105,35
357,Marcy,57,99,30,186,62
358,Moreen,76,9,69,154,51.3333333333
359,Costanza,36,97,63,196,65.3333333333
360,Nannie,7,77,83,167,55.6666666667
361,Fred,20,86,45,151,50.3333333333
362,Stevy,57,69,35,161,53.6666666667
363,Hyman,30,45,2,77,25.6666666667
364,Jobey,20,12,39,71,23.6666666667
365,Irvin,67,59,11,137,45.6666666667
366,Mead,5,90,32,127,42.3333333333
367,Anna-diana,90,24,68,182,60.6666666667
368,Shannon,70,71,29,170,56.6666666667
369,Beatrice,78,24,17,119,39.6666666667
370,Anni,43,5,61,109,36.3333333333
371,Annmaria,84,47,76,207,69
372,Alejandrina,42,70,36,148,49.3333333333
373,Spike,19,5,52,76,25.3333333333
374,Kellina,65,18,95,178,59.3333333333
375,Ludwig,62,24,16,102,34
376,Elly,49,20,40,109,36.3333333333
377,Bond,95,15,91,201,67
378,Hetty,44,77,21,142,47.3333333333
379,Tabatha,1,18,52,71,23.6666666667
380,Cleavland,44,9,68,121,40.3333333333
381,Kiel,20,60,85,165,55
382,Cheri,62,12,3,77,25.6666666667
383,Kenna,75,41,85,201,67
384,Tab,20,71,43,134,44.6666666667
385,Winna,32,6,97,135,45
386,Demott,11,67,10,88,29.3333333333
387,Patric,30,49,1,80,26.6666666667
388,Silas,37,76,14,127,42.3333333333
389,Grissel,92,81,74,247,82.3333333333
390,Zechariah,38,41,87,166,55.3333333333
391,Simonette,6,47,78,131,43.6666666667
392,Trever,33,34,98,165,55
393,Ally,99,92,11,202,67.3333333333
394,Miltie,55,48,17,120,40
395,Jeramie,47,35,81,163,54.3333333333
396,Caddric,5,82,95,182,60.6666666667
397,Lukas,51,66,50,167,55.6666666667
398,Jessalyn,54,86,36,176,58.6666666667
399,Phillipe,82,48,37,167,55.6666666667
400,Kalindi,15,61,48,124,41.3333333333
401,Franny,84,57,38,179,59.6666666667
402,Corly,55,61,83,199,66.3333333333
403,Dev,90,97,24,211,70.3333333333
404,Amalia,76,66,74,216,72
405,Mel,55,54,70,179,59.6666666667
406,Darda,74,22,35,131,43.6666666667
407,Eliot,29,30,69,128,42.6666666667
408,Leo,32,94,97,223,74.3333333333
409,Ellissa,81,32,14,127,42.3333333333
410,Darrick,94,12,27,133,44.3333333333
411,Kile,3,3,54,60,20
412,Ashien,5,70,7,82,27.3333333333
413,Cristy,52,50,46,148,49.3333333333
414,Sheeree,66,34,29,129,43
415,Emmanuel,82,23,31,136,45.3333333333
416,Konstanze,30,75,7,112,37.3333333333
417,Nolana,23,67,8,98,32.6666666667
418,Dorrie,82,86,98,266,88.6666666667
419,Tera,25,30,81,136,45.3333333333
420,Gertrud,25,69,99,193,64.3333333333
421,Dora,10,22,83,115,38.3333333333
422,Randee,61,32,38,131,43.6666666667
423,Elysia,14,74,32,120,40
424,Terrance,49,8,27,84,28
425,Moll,22,44,9,75,25
426,Adina,7,11,20,38,12.6666666667
427,Lydon,22,40,94,156,52
428,Bathsheba,59,1,88,148,49.3333333333
429,Vickie,15,58,63,136,45.3333333333
430,Valeda,18,18,86,122,40.6666666667
431,Ancell,90,37,76,203,67.6666666667
432,Gertie,96,94,68,258,86
433,Mufi,39,67,18,124,41.3333333333
434,Lauralee,26,26,54,106,35.3333333333
435,Courtnay,90,31,74,195,65
436,Dag,19,52,87,158,52.6666666667
437,Lotty,64,42,33,139,46.3333333333
438,Randa,91,41,45,177,59
439,Lillian,90,71,94,255,85
440,Moritz,77,85,15,177,59
441,Laure,56,63,30,149,49.6666666667
442,Simeon,33,89,70,192,64
443,Jennee,13,71,98,182,60.6666666667
444,Lauren,31,22,89,142,47.3333333333
445,Marshal,9,48,29,86,28.6666666667
446,Bill,89,93,25,207,69
447,Valery,80,35,51,166,55.3333333333
448,Koral,41,20,9,70,23.3333333333
449,Nicoline,21,23,95,139,46.3333333333
450,Benjamen,63,92,87,242,80.6666666667
451,Son,39,71,22,132,44
452,Sondra,78,39,36,153,51
453,Sarina,67,13,74,154,51.3333333333
454,Dolph,49,41,14,104,34.6666666667
455,Josefina,41,29,29,99,33
456,Hartwell,91,63,33,187,62.3333333333
457,Kalindi,31,1,54,86,28.6666666667
458,Corabel,11,52,41,104,34.6666666667
459,Evita,94,73,22,189,63
460,Findley,81,60,9,150,50
461,Dew,84,53,7,144,48
462,Rhona,46,39,76,161,53.6666666667
463,Reta,10,97,67,174,58
464,Simon,4,19,71,94,31.3333333333
465,Tonnie,29,56,51,136,45.3333333333
466,Mariejeanne,25,7,58,90,30
467,Ray,26,100,44,170,56.6666666667
468,Leela,28,8,97,133,44.3333333333
469,Ely,11,92,30,133,44.3333333333
470,Umeko,82,2,14,98,32.6666666667
471,Saudra,53,49,76,178,59.3333333333
472,Oliy,8,6,26,40,13.3333333333
473,Tate,60,24,96,180,60
474,Benedict,98,38,77,213,71
475,Hollie,36,85,62,183,61
476,Gunar,53,32,34,119,39.6666666667
477,Beitris,79,12,93,184,61.3333333333
478,Odella,65,29,39,133,44.3333333333
479,Glen,90,68,99,257,85.6666666667
480,Pierrette,41,66,68,175,58.3333333333
481,Trip,90,25,86,201,67
482,Boony,27,31,11,69,23
483,Borden,26,25,69,120,40
484,Tatum,29,22,76,127,42.3333333333
485,Nollie,16,25,89,130,43.3333333333
486,Aloin,61,6,46,113,37.6666666667
487,Hugo,12,33,41,86,28.6666666667
488,Thane,73,18,90,181,60.3333333333
489,Bari,50,80,83,213,71
490,Christophorus,42,56,62,160,53.3333333333
491,Sharleen,99,12,80,191,63.6666666667
492,Christen,35,23,55,113,37.6666666667
493,Karine,60,56,84,200,66.6666666667
494,Aimee,12,71,92,175,58.3333333333
495,Brendan,6,7,46,59,19.6666666667
496,Pietro,19,98,3,120,40
497,Elbert,7,29,82,118,39.3333333333
498,Pauli,50,40,65,155,51.6666666667
499,Goldia,30,78,70,178,59.3333333333
500,Packston,42,37,64,143,47.6666666667
501,Petey,6,86,43,135,45
502,Bess,46,58,80,184,61.3333333333
503,Malissa,99,56,1,156,52
504,Koenraad,69,40,74,183,61
505,Lemar,29,43,39,111,37
506,Glory,69,4,76,149,49.6666666667
507,Westleigh,33,81,26,140,46.6666666667
508,Pebrook,15,57,9,81,27
509,Padgett,19,62,65,146,48.6666666667
510,Pierson,8,92,43,143,47.6666666667
511,Chere,96,64,80,240,80
512,Marge,58,92,30,180,60
513,Berny,82,75,76,233,77.6666666667
514,Rod,85,92,20,197,65.6666666667
515,Avigdor,58,53,98,209,69.6666666667
516,Ludovico,87,42,51,180,60
517,Dulcinea,86,2,59,147,49
518,Gerti,28,25,6,59,19.6666666667
519,Arabelle,40,38,70,148,49.3333333333
520,Mehetabel,76,98,6,180,60
521,Tiff,13,37,72,122,40.6666666667
522,Jaime,95,88,1,184,61.3333333333
523,Julina,29,84,11,124,41.3333333333
524,Ayn,88,24,34,146,48.6666666667
525,Yorgos,43,17,39,99,33
526,Darsie,54,45,35,134,44.6666666667
527,Virgina,30,19,40,89,29.6666666667
528,Bronson,22,83,83,188,62.6666666667
529,Riordan,77,77,7,161,53.6666666667
530,Sophie,96,49,82,227,75.6666666667
531,Candace,39,77,87,203,67.6666666667
532,Noni,37,5,52,94,31.3333333333
533,Toiboid,29,84,97,210,70
534,Shaine,17,37,64,118,39.3333333333
535,Dareen,41,51,63,155,51.6666666667
536,Holli,53,23,18,94,31.3333333333
537,Tish,88,52,80,220,73.3333333333
538,Rickert,26,24,34,84,28
539,Delmer,46,72,66,184,61.3333333333
540,Templeton,43,81,15,139,46.3333333333
541,Jacquetta,4,71,92,167,55.6666666667
542,Charita,29,9,49,87,29
543,Byrle,6,16,94,116,38.6666666667
544,Ingaberg,9,19,35,63,21
545,Kiley,65,100,87,252,84
546,Vasilis,39,77,46,162,54
547,Annissa,85,65,6,156,52
548,Anabel,88,94,13,195,65
549,Tucky,67,91,2,160,53.3333333333
550,Turner,82,77,73,232,77.3333333333
551,Dorella,69,83,57,209,69.6666666667
552,Georgie,40,66,3,109,36.3333333333
553,Virginia,32,98,56,186,62
554,Gage,89,87,5,181,60.3333333333
555,Kendal,57,81,17,155,51.6666666667
556,Mildred,34,76,99,209,69.6666666667
557,Lottie,5,5,51,61,20.3333333333
558,Lyn,18,32,36,86,28.6666666667
559,Beulah,84,91,35,210,70
560,Benjamin,56,68,96,220,73.3333333333
561,Abra,78,60,16,154,51.3333333333
562,Elayne,55,23,90,168,56
563,Roarke,87,58,17,162,54
564,Arel,95,7,37,139,46.3333333333
565,Steven,26,90,77,193,64.3333333333
566,Stefano,14,60,85,159,53
567,Claiborn,38,49,72,159,53
568,Ninnetta,93,89,5,187,62.3333333333
569,Rori,14,46,32,92,30.6666666667
570,Moira,63,33,6,102,34
571,Katharine,53,65,69,187,62.3333333333
572,Guglielma,13,71,87,171,57
573,Roxana,36,59,15,110,36.6666666667
574,Terese,33,26,17,76,25.3333333333
575,Anatole,84,11,74,169,56.3333333333
576,Kessiah,77,32,31,140,46.6666666667
577,Loise,8,26,90,124,41.3333333333
578,Wait,41,40,75,156,52
579,Kaela,86,30,50,166,55.3333333333
580,Catina,98,63,46,207,69
581,Gal,24,61,17,102,34
582,Ezequiel,45,34,12,91,30.3333333333
583,Vi,83,69,84,236,78.6666666667
584,Rubia,8,22,33,63,21
585,Debra,86,15,87,188,62.6666666667
586,Zack,53,8,75,136,45.3333333333
587,Filippo,98,82,34,214,71.3333333333
588,Aldous,31,52,66,149,49.6666666667
589,Dacey,43,69,80,192,64
590,Llewellyn,6,8,60,74,24.6666666667
591,Clive,43,60,67,170,56.6666666667
592,Gideon,57,68,20,145,48.3333333333
593,Quintilla,55,82,64,201,67
594,Mallorie,13,5,94,112,37.3333333333
595,Terri,63,80,21,164,54.6666666667
596,Arlie,32,36,95,163,54.3333333333
597,Yolande,23,34,15,72,24
598,Vernen,81,28,73,182,60.6666666667
599,Hewet,42,50,16,108,36
600,Maurene,21,77,2,100,33.3333333333
601,Bill,18,3,71,92,30.6666666667
602,Osmund,26,47,37,110,36.6666666667
603,Anatola,28,76,1,105,35
604,Dewain,28,3,51,82,27.3333333333
605,Rhea,56,69,40,165,55
606,Vicky,6,45,75,126,42
607,Maxie,35,18,44,97,32.3333333333
608,Julius,5,49,35,89,29.6666666667
609,Brietta,8,24,89,121,40.3333333333
610,Maurine,44,23,58,125,41.6666666667
611,Chelsy,43,93,85,221,73.6666666667
612,Cammie,51,65,7,123,41
613,Friederike,78,88,82,248,82.6666666667
614,Boothe,42,91,54,187,62.3333333333
615,Wendel,65,28,27,120,40
616,Mina,80,48,64,192,64
617,Bearnard,39,39,26,104,34.6666666667
618,Alyce,89,93,5,187,62.3333333333
619,Colette,4,25,78,107,35.6666666667
620,Claudine,86,97,88,271,90.3333333333
621,Amelita,64,46,75,185,61.6666666667
622,Margareta,99,49,3,151,50.3333333333
623,Rodd,97,64,53,214,71.3333333333
624,Brittany,68,98,74,240,80
625,Cristi,1,40,4,45,15
626,Hattie,96,87,89,272,90.6666666667
627,Ariel,35,5,39,79,26.3333333333
628,Upton,50,77,50,177,59
629,Marnie,86,8,96,190,63.3333333333
630,Devonna,23,82,25,130,43.3333333333
631,Alberto,43,71,41,155,51.6666666667
632,Bethina,25,61,58,144,48
633,Sukey,42,17,1,60,20
634,Alwin,20,59,87,166,55.3333333333
635,Anders,64,31,36,131,43.6666666667
636,Port,15,15,72,102,34
637,Sapphire,60,32,88,180,60
638,Carmine,74,56,41,171,57
639,Elicia,84,76,76,236,78.6666666667
640,Camile,90,86,1,177,59
641,Darbee,89,56,93,238,79.3333333333
642,Fairleigh,52,57,93,202,67.3333333333
643,Gael,28,36,95,159,53
644,Hewett,29,44,69,142,47.3333333333
645,Fabio,4,97,70,171,57
646,Alexia,24,23,36,83,27.6666666667
647,Bail,11,25,83,119,39.6666666667
648,Camala,83,95,33,211,70.3333333333
649,Daile,85,72,79,236,78.6666666667
650,Erek,57,12,51,120,40
651,Nedda,57,56,74,187,62.3333333333
652,Arlee,99,98,65,262,87.3333333333
653,Sherline,36,90,83,209,69.6666666667
654,Tandie,32,16,37,85,28.3333333333
655,Jo-anne,96,83,55,234,78
656,Edsel,77,29,63,169,56.3333333333
657,Christen,14,19,31,64,21.3333333333
658,Carson,95,77,60,232,77.3333333333
659,Amelita,31,76,28,135,45
660,Zita,81,22,18,121,40.3333333333
661,Vaughan,72,30,8,110,36.6666666667
662,Lila,57,61,77,195,65
663,Ellwood,78,80,91,249,83
664,Bar,36,41,88,165,55
665,Gerri,65,68,76,209,69.6666666667
666,Itch,10,26,7,43,14.3333333333
667,Agnes,42,68,56,166,55.3333333333
668,Brianna,3,60,14,77,25.6666666667
669,Blythe,26,47,31,104,34.6666666667
670,Krystle,68,18,35,121,40.3333333333
671,Marchelle,76,65,59,200,66.6666666667
672,Lisabeth,64,89,58,211,70.3333333333
673,Darell,71,99,46,216,72
674,Marcelia,55,32,30,117,39
675,Sholom,17,93,21,131,43.6666666667
676,Berri,79,24,47,150,50
677,Lorinda,88,97,84,269,89.6666666667
678,Lucy,74,84,79,237,79
679,Lani,31,46,78,155,51.6666666667
680,Kirstyn,86,63,62,211,70.3333333333
681,Alf,24,66,64,154,51.3333333333
682,Barbra,74,62,78,214,71.3333333333
683,Melisandra,5,79,6,90,30
684,Sally,41,58,5,104,34.6666666667
685,Carlynn,94,77,41,212,70.6666666667
686,Myrvyn,3,16,63,82,27.3333333333
687,Annabal,84,62,41,187,62.3333333333
688,Caty,71,21,87,179,59.6666666667
689,Elysia,76,12,8,96,32
690,Maurise,93,58,12,163,54.3333333333
691,Francis,14,2,49,65,21.6666666667
692,Kermie,46,16,78,140,46.6666666667
693,Hazel,40,13,12,65,21.6666666667
694,Winnah,58,44,11,113,37.6666666667
695,Roshelle,32,100,6,138,46
696,Vina,8,6,8,22,7.3333333333
697,Ronald,63,46,20,129,43
698,Rowen,56,73,4,133,44.3333333333
699,Nero,15,76,85,176,58.6666666667
700,Brianne,86,52,47,185,61.6666666667
701,Penn,39,21,46,106,35.3333333333
702,Rosalynd,84,53,4,141,47
703,Alyssa,86,79,68,233,77.6666666667
704,Branden,42,45,38,125,41.6666666667
705,Ellwood,83,83,81,247,82.3333333333
706,Star,39,14,97,150,50
707,Roch,57,81,38,176,58.6666666667
708,Brok,89,39,62,190,63.3333333333
709,Albina,50,45,87,182,60.6666666667
710,Sibyl,89,83,28,200,66.6666666667
711,Meryl,23,44,49,116,38.6666666667
712,Didi,57,2,34,93,31
713,Brose,87,99,45,231,77
714,Kata,87,95,75,257,85.6666666667
715,Grier,66,97,7,170,56.6666666667
716,Domeniga,86,26,91,203,67.6666666667
717,Cord,36,22,20,78,26
718,Mirabella,72,55,39,166,55.3333333333
719,Tallie,80,33,8,121,40.3333333333
720,Darline,78,14,26,118,39.3333333333
721,Elly,45,48,49,142,47.3333333333
722,Goldia,40,60,7,107,35.6666666667
723,Kathye,89,27,26,142,47.3333333333
724,Vivyan,7,52,49,108,36
725,Paige,27,44,65,136,45.3333333333
726,Archibald,17,56,85,158,52.6666666667
727,Pavlov,82,80,75,237,79
728,Paulie,99,91,87,277,92.3333333333
729,Stafani,82,19,73,174,58
730,Haywood,85,50,25,160,53.3333333333
731,Orlando,77,81,52,210,70
732,Abeu,72,57,94,223,74.3333333333
733,Jarrid,93,97,70,260,86.6666666667
734,Abigale,26,97,64,187,62.3333333333
735,Ladonna,75,96,12,183,61
736,Mill,79,89,51,219,73
737,Jobi,3,66,41,110,36.6666666667
738,Linda,54,78,34,166,55.3333333333
739,Vida,35,61,100,196,65.3333333333
740,Brena,67,28,59,154,51.3333333333
741,Dominica,85,83,33,201,67
742,Cathrine,54,41,81,176,58.6666666667
743,Lorenzo,100,56,85,241,80.3333333333
744,Ruby,65,4,39,108,36
745,Ivar,62,98,67,227,75.6666666667
746,Rori,1,17,18,36,12
747,Veda,18,11,91,120,40
748,Chauncey,20,3,44,67,22.3333333333
749,Leia,59,27,45,131,43.6666666667
750,Galvin,33,95,55,183,61
751,Kassie,87,28,9,124,41.3333333333
752,Cross,25,98,15,138,46
753,Bridie,57,87,78,222,74
754,Rasla,5,83,3,91,30.3333333333
755,Clair,95,30,12,137,45.6666666667
756,Alard,49,13,74,136,45.3333333333
757,Jefferey,41,81,48,170,56.6666666667
758,Murry,24,26,89,139,46.3333333333
759,Sarah,7,93,15,115,38.3333333333
760,Nancie,47,15,30,92,30.6666666667
761,North,21,69,7,97,32.3333333333
762,Madelina,13,49,12,74,24.6666666667
763,Burnaby,33,98,45,176,58.6666666667
764,Willi,26,43,35,104,34.6666666667
765,Anya,28,19,45,92,30.6666666667
766,Flynn,97,47,13,157,52.3333333333
767,Ferdinanda,49,17,43,109,36.3333333333
768,Meridel,39,83,26,148,49.3333333333
769,Ursuline,60,13,60,133,44.3333333333
770,Dwain,33,29,90,152,50.6666666667
771,Rora,72,49,5,126,42
772,Goldarina,68,47,98,213,71
773,Yelena,54,51,17,122,40.6666666667
774,Dottie,79,50,96,225,75
775,Bob,67,91,70,228,76
776,Annabel,68,56,20,144,48
777,Andras,7,9,53,69,23
778,Rex,67,70,78,215,71.6666666667
779,Jaymee,89,63,70,222,74
780,Perkin,4,14,71,89,29.6666666667
781,Noelyn,55,84,67,206,68.6666666667
782,Yehudit,11,84,91,186,62
783,Wilmar,45,13,76,134,44.6666666667
784,Selig,9,26,78,113,37.6666666667
785,Darryl,67,86,94,247,82.3333333333
786,Ray,82,64,93,239,79.6666666667
787,Raddie,92,6,85,183,61
788,Oliy,11,45,13,69,23
789,Jobie,92,18,38,148,49.3333333333
790,Vonnie,1,92,9,102,34
791,Lizette,87,49,22,158,52.6666666667
792,Gabriellia,64,6,87,157,52.3333333333
793,Hyatt,85,6,41,132,44
794,Katherine,3,69,17,89,29.6666666667
795,Cecil,32,84,57,173,57.6666666667
796,Elena,26,2,2,30,10
797,Riane,15,95,77,187,62.3333333333
798,Husein,79,21,51,151,50.3333333333
799,Edan,21,30,44,95,31.6666666667
800,Johnette,4,17,8,29,9.6666666667
801,Wilmette,5,29,43,77,25.6666666667
802,Kristyn,18,95,58,171,57
803,Fairfax,27,12,29,68,22.6666666667
804,Nathalia,7,54,70,131,43.6666666667
805,Marthena,24,47,50,121,40.3333333333
806,Desdemona,9,47,98,154,51.3333333333
807,Kylynn,64,11,24,99,33
808,Rancell,24,63,99,186,62
809,Audrie,61,7,8,76,25.3333333333
810,Marne,69,65,20,154,51.3333333333
811,Joleen,32,6,34,72,24
812,Cesya,66,22,99,187,62.3333333333
813,Demott,46,8,57,111,37
814,Diannne,99,91,34,224,74.6666666667
815,Nanete,16,80,56,152,50.6666666667
816,Salaidh,99,54,91,244,81.3333333333
817,Jessamine,89,80,18,187,62.3333333333
818,Glyn,24,29,72,125,41.6666666667
819,Witty,38,94,21,153,51
820,Gabriell,72,5,10,87,29
821,Jolie,27,10,37,74,24.6666666667
822,Nettie,83,31,19,133,44.3333333333
823,Kristy,4,39,78,121,40.3333333333
824,Marrissa,31,24,91,146,48.6666666667
825,Adelheid,20,13,98,131,43.6666666667
826,Noll,24,39,71,134,44.6666666667
827,Justus,39,56,36,131,43.6666666667
828,Tomasine,72,100,41,213,71
829,Coralyn,70,29,83,182,60.6666666667
830,Gus,97,89,40,226,75.3333333333
831,Gardener,52,61,52,165,55
832,Mignonne,49,97,51,197,65.6666666667
833,Shaine,82,18,78,178,59.3333333333
834,Lewiss,36,29,32,97,32.3333333333
835,Britt,35,51,76,162,54
836,Carly,32,74,7,113,37.6666666667
837,Virge,74,75,91,240,80
838,Flem,1,4,10,15,5
839,Hilde,93,64,94,251,83.6666666667
840,La verne,19,79,17,115,38.3333333333
841,Rosa,73,23,65,161,53.6666666667
842,Kittie,88,63,99,250,83.3333333333
843,Aliza,81,49,75,205,68.3333333333
844,Anna-diane,18,48,31,97,32.3333333333
845,Lorette,89,35,76,200,66.6666666667
846,Kristine,30,61,14,105,35
847,Maggie,88,2,61,151,50.3333333333
848,Suzi,99,15,79,193,64.3333333333
849,Wells,43,81,66,190,63.3333333333
850,Martainn,77,69,33,179,59.6666666667
851,Reinaldo,22,86,20,128,42.6666666667
852,Lorena,65,2,72,139,46.3333333333
853,Frederigo,93,21,85,199,66.3333333333
854,Octavius,84,41,20,145,48.3333333333
855,Leonora,45,57,89,191,63.6666666667
856,Jaquenette,69,18,44,131,43.6666666667
857,Kellen,47,95,16,158,52.6666666667
858,Sterling,12,68,39,119,39.6666666667
859,Elmo,62,82,20,164,54.6666666667
860,Bobina,88,31,89,208,69.3333333333
861,Bondy,84,96,58,238,79.3333333333
862,Jere,63,76,14,153,51
863,Ilyssa,65,57,55,177,59
864,Pip,38,51,45,134,44.6666666667
865,Bob,98,56,14,168,56
866,Clary,93,57,99,249,83
867,Barbe,58,63,64,185,61.6666666667
868,Rasia,87,67,93,247,82.3333333333
869,Ally,88,8,55,151,50.3333333333
870,Egor,97,59,49,205,68.3333333333
871,Shelley,21,70,98,189,63
872,Brit,63,31,34,128,42.6666666667
873,Bamby,37,11,77,125,41.6666666667
874,Sylvan,25,79,3,107,35.6666666667
875,Fawne,76,23,92,191,63.6666666667
876,Lisle,91,78,77,246,82
877,Shellie,96,67,69,232,77.3333333333
878,Crawford,76,13,46,135,45
879,Bartel,80,74,50,204,68
880,Gene,99,13,84,196,65.3333333333
881,Sollie,29,67,79,175,58.3333333333
882,Della,7,1,4,12,4
883,Ronalda,86,15,21,122,40.6666666667
884,Lavina,28,15,64,107,35.6666666667
885,Katalin,4,22,14,40,13.3333333333
886,Horacio,54,42,22,118,39.3333333333
887,Lynnelle,56,23,25,104,34.6666666667
888,Ginger,16,44,53,113,37.6666666667
889,Davide,95,39,74,208,69.3333333333
890,Esme,93,40,18,151,50.3333333333
891,Johnathan,30,47,49,126,42
892,Heddie,80,45,73,198,66
893,Collete,96,32,17,145,48.3333333333
894,Gerard,72,66,90,228,76
895,Ina,90,95,63,248,82.6666666667
896,Zorine,90,60,77,227,75.6666666667
897,Stormy,8,78,94,180,60
898,Odette,39,22,60,121,40.3333333333
899,Omero,6,19,95,120,40
900,Miller,38,67,56,161,53.6666666667
901,Brietta,100,37,1,138,46
902,Hercules,29,73,67,169,56.3333333333
903,Julienne,39,33,38,110,36.6666666667
904,Adelheid,85,45,74,204,68
905,Idell,38,34,6,78,26
906,Marget,26,37,33,96,32
907,Adriane,59,30,88,177,59
908,Aaron,5,82,37,124,41.3333333333
909,Isidore,56,19,89,164,54.6666666667
910,Emmi,87,10,83,180,60
911,Hali,44,40,94,178,59.3333333333
912,Melesa,6,10,93,109,36.3333333333
913,Editha,36,99,16,151,50.3333333333
914,Issie,87,60,48,195,65
915,Theobald,58,36,61,155,51.6666666667
916,Rea,59,2,73,134,44.6666666667
917,Kenyon,16,12,45,73,24.3333333333
918,Gill,92,58,42,192,64
919,Vanessa,11,72,39,122,40.6666666667
920,Susanna,17,29,77,123,41
921,Shel,68,99,54,221,73.6666666667
922,Pavel,70,82,8,160,53.3333333333
923,Donal,88,20,50,158,52.6666666667
924,Ardeen,99,23,39,161,53.6666666667
925,Rick,94,8,51,153,51
926,Patricia,86,22,60,168,56
927,Winonah,42,17,15,74,24.6666666667
928,Murry,8,33,67,108,36
929,Chicky,21,14,65,100,33.3333333333
930,Corissa,49,96,41,186,62
931,Evonne,73,27,39,139,46.3333333333
932,Denny,100,96,3,199,66.3333333333
933,Natalee,85,77,13,175,58.3333333333
934,Stephie,99,75,39,213,71
935,Maiga,9,17,49,75,25
936,Gerri,1,2,91,94,31.3333333333
937,Jonie,75,65,58,198,66
938,Con,17,53,78,148,49.3333333333
939,Tymothy,100,29,5,134,44.6666666667
940,Demetre,63,19,20,102,34
941,Timofei,29,68,67,164,54.6666666667
942,Tally,10,21,60,91,30.3333333333
943,Adolph,74,30,84,188,62.6666666667
944,Reina,23,8,56,87,29
945,Rosalia,50,62,21,133,44.3333333333
946,Micah,97,3,23,123,41
947,Martguerita,58,1,89,148,49.3333333333
948,Darcey,14,26,47,87,29
949,Kaylee,43,99,18,160,53.3333333333
950,Gianni,1,67,30,98,32.6666666667
951,Ring,60,15,97,172,57.3333333333
952,Jabez,26,58,15,99,33
953,Clementine,96,13,55,164,54.6666666667
954,Madella,65,16,93,174,58
955,Sig,85,39,53,177,59
956,Rockie,49,74,43,166,55.3333333333
957,Ally,8,47,3,58,19.3333333333
958,Lauraine,81,9,88,178,59.3333333333
959,Mel,58,14,66,138,46
960,Gui,24,13,75,112,37.3333333333
961,Tisha,44,4,74,122,40.6666666667
962,Shelley,47,24,34,105,35
963,Evy,93,56,98,247,82.3333333333
964,Phillipe,10,42,57,109,36.3333333333
965,Rickert,42,93,61,196,65.3333333333
966,Merrill,94,18,42,154,51.3333333333
967,Alwin,77,70,40,187,62.3333333333
968,Erik,14,24,62,100,33.3333333333
969,Alessandra,26,55,28,109,36.3333333333
970,Pyotr,26,77,51,154,51.3333333333
971,Nanete,61,71,24,156,52
972,Lyndy,100,24,63,187,62.3333333333
973,Candy,24,19,59,102,34
974,Cam,24,16,91,131,43.6666666667
975,Rollins,53,64,88,205,68.3333333333
976,Jobi,68,52,69,189,63
977,Sandie,63,97,59,219,73
978,Orelee,78,27,25,130,43.3333333333
979,Randa,43,56,94,193,64.3333333333
980,Waneta,25,9,18,52,17.3333333333
981,Laurice,58,20,20,98,32.6666666667
982,Wendeline,98,45,75,218,72.6666666667
983,Niki,66,86,36,188,62.6666666667
984,Tiebout,6,78,85,169,56.3333333333
985,Lorilyn,82,83,1,166,55.3333333333
986,Lindy,91,6,78,175,58.3333333333
987,Scotti,96,64,2,162,54
988,Franky,79,79,33,191,63.6666666667
989,Ashley,50,42,38,130,43.3333333333
990,Rani,87,65,10,162,54
991,Ezekiel,88,40,98,226,75.3333333333
992,Shawn,56,16,82,154,51.3333333333
993,Edgard,83,90,22,195,65
994,Katy,30,15,80,125,41.6666666667
995,Giacobo,35,65,32,132,44
996,Alden,2,82,39,123,41
997,Lennie,29,55,31,115,38.3333333333
998,Mair,31,63,98,192,64
999,Brett,66,50,83,199,66.3333333333
1000,Beniamino,89,89,93,271,90.3333333333
